NO ./textures/greystone.xpm
SO ./textures/mossy.xpm
WE ./textures/purplestone.xpm
EA ./textures/white_wall.xpm

F 000,000,255
C 225,000,000

1111111111111111111111111111111111111111111111111111111111111111111111111111111111
1000000000000000000000000000000000000000000000000000000000000000000000000000000001
1000000000000000000000000000000000000000000000000000000000000000000000000000000001
1000000000000111111111000000000000000000000000000000000000000000000000000000000001
1000000000000100000001000000000000000000000000000000000000000000000111111111111111
10000000000000000000010000000000000000000000000000000000000000000001
1000000000000100000001000000000000000000000000000000000000000000000111111111111111
1000000000000111111111000000000000000000000000000000000000000000000000000000000001
1000000000000000000000000000000000000000000000000000000000000000000000000000000001
1000000000000000000000000000000000000000000000000000000000000000000000000000000001
1000000000000000000000000000000000000000000000000000000000000000000000000000000001
1000000000000000000000000000000000000000000000000000000000000000000000000000000001
1000000000000000000000000000000000000000000000000000000000000000000000000000000001
1000000000000000000000000000000000000000000000000000000000000000000000000000000001
1000000000000000110000000000000000000000000000000000000000000000000000000000000001
1000000000000000000000000000000000000000000000000000000000000000000000100000000001
1000000000000000000000000000000000000001000000000000000000000000000000100000000001
1000000000000000000000000000000000000000000000000000000000000000000000000000000001
1000000000000000000000000000000000000000000000000000000000000000000000000000000001
1000000000000000000000000000000000000000000000000000000000000000000000000000000001
1000000000000000000000000000000000000000000000000000000000000000000000000000000001
1000000000000000000000000000000000000000000000000000000000000000000000000000000001
1000000000000000000000000000000000000000000000000000000000000000000000000000000001
1000000000001111111111111000000000000000000000000000000000000000000000000000000001
1000000000000000000000000000000000000000000000000000011110000000000000000000000001
1000000000000000000000000000000000000000000000000000000010000000000000000000000001
1000000000000000000000000000000000000000000000000000000010000000000000000000000001
1000000000000000000000000000000000000000000000000000000010000000000000000000000001
1000000000000000000000000000000000000000000000000000000000000000000000000000000001
1000000000000000000000000000000000000000000000000000000000000000000000000000000001
1000000000000000000000000000000000000000000000000000000000000000000000000000000001
1000000000000000000000000000000000000000000000000000000000000000000000000000000001
1000000000000000000000000000000000000000000000000000000000000000000000000000000001
1000000000000000000000000000000000000000000000000000000000000000000000000000000001
1000000000000000000000000111111000000000000000000000000000001000000000000000000001
1000000000000000000000000100000000000000000000000000000000001000000000000000000001
1000000000000000000000000100000000000000000000000000000000001000000000000000000001
1000000000000000000000000100000000000000000000000001111111111000000000000000000001
1000000000000000000000000000000000000000000000000000000000000000000000000000000001
100000000000000000000000000000000000000000000000000000000000000000000000000000001
10000000000000000000000000000000000000000000000000000000000000000000000000000001
1000000000000000000000000000000000000000000000000000000000000000000000000000111
10000000000000000000000000000000000000000000000000101000000000000000000000001
1000000000000000000000000000000000000000000000000000000000000000000000000000111111
1000000000000000000000100000000000000000000000000000000000000000000000000000000001
1000000000000000000000100000000000000000000000000000000000000000000000000000000001
1000000000000000000000111111111111110000000000000000000000000000000000000000000001
1000000000000000000000000000000000000000000000000000000000000000000000000000000001
1000000000000000000000000000000000000000000000000000000000000000000000000000000001
1000000000000000000000000000000000000000000000000000000000000000000000000000000001
1000000000000000000000000000000000000000000000000000000000000000000000000000000001
1000000000000000000000000000000000000000000000000000000000000000000000000000000001
1000000000000000000000000000000000000000000000000000000000000000000000000000000001
1000000000000000000000000000000000000000000000000000000000000000000000000000000001
1000000000000000000000000000000000000000000000000000000000000000000000000000000001
1000000000000000000000000000000000000000000000000000000000000000000000000000000001
1000000000000000000000000000000000000000000000000000000000000000000000000000N00001
1111111111111111111111111111111111111111111111111111111111111111111111111111111111

