111111111111111
100011111100001
100000100010001
100000011000001
100N00000000001
111111111111111