NO ./textures/greystone.xpm
SO ./textures/mossy.xpm
WE ./textures/purplestone.xpm
EA ./textures/white_wall.xpm

F 255,000,000
C 000,000,255

11111111111111
10000000000001
10000111000001 
10000101000001
100001D1000001
10000000000001
1000000000N001
11111111111111