NO ./textures/greystone.xpm
SO ./textures/mossy.xpm
WE ./textures/purplestone.xpm
EA ./textures/white_wall.xpm

F 255,000,000
C 000,000,255












		 111111    11111
		 100001    10001        1
		 1000N1    10001   1111101
		 111111    11111        1
                 
     111111111    
     100000001    
     111111111 



	 