NO ./textures/fighting.xpm
SO ./textures/queen.xpm
WE ./textures/piero.xpm
EA ./textures/vic.xpm

F 156,17, 	158 
C 158,121,55











		 111111    11111
		 100001    10001        1
		 1000N1    10001   1111101
		 111111    11111        1
                 
	 111111111    
	 100010001
	 1001 1001
	 100010001   
	 111111111 



	 