
NO ./textures/north.xpm
SO ./textures/south.xpm
WE ./textures/west.xpm
EA ./textures/east.xpm
F 220,100,0
C 225,30,0

111111    11111
100001    10001
1000N1    10001
111111    11111
              
     111111111
     100000001
     111111111